7|0|0;3|1|5
-;
1|4|9;6|4|8
-;
8|5|7;1|0|6
-;
6|9|8;5|7|0
-;
0|3|3;4|0|9
