6|1|0;6|4|8
-;
5|3|1;9|4|0
-;
0|7|5;3|3|0
-;
8|6|9;0|0|7
-;
5|7|8;9|1|4
