0|0|9;7|0|4
-;
4|3|3;6|0|8
-;
5|0|7;9|4|1
-;
6|1|8;3|9|5
-;
1|5|6;7|0|8
